XXXXXXXXXXXXMXXXXMXXXXMXXXXXXX
XOXTOOXXOOOOOOOTXOOOXXOOOOOOTM
XOXXXOOOOXXXOXXOOOXOOXODXOXXOX
XOOOXOXXOXOOOOXXOXXXOOOOXOXXOX
XOXOOOOOOXOXXOOXOOOXOXXOOOOOOM
XOXXOXOXXXOXXXOXXXOOOOXOXXOXTX
XOOOOXOOOXOOOOTOOXXOXOOOOOOXXX
XOXXOXOXOOOXXXXXOOOOXOXXOXOOOM
XOTXOOOOOXXXOOOXXXXOOOOXXXOXOX
XOXXOXXXOOXXOXOOXTXXOXOOOOOXOX
XOOOOOOXXOOOOXXOXOOXOXXXXXOXOX
XXXOXXOOXXOXXXOOXXOOOXOOOXOXTX
MOOOOOOXXOOOOOOXXXXXOXOXOOOXXX
XTXDOXOOOOXXXXOOOOOOOXTXXXOOOX
XXXXMXXXXXXXXXMXXXXXXXMXXXXXXX