╔════╦══╦╤═╦════╦══╤══67══╤╦═╗
║OOOO║TO║OO║OOOOvOOOOO└┘OOOvT║
║O╔>O╚╗O╚>O╚╗T^OOO^O^OOOO^OOO╢
║O║OOOvOOOOO╚═╝O<═╣O╚═6┐O║O^O║
║O╚═╗OOO╔═╗OOOOOOO║OOO└9OvO║O║
║OOO╚>O<╝TvO╔═╦═>O╚═╗OO║OOOvO║
║O^OOOOOOOOO║DvOOOOO╠>O╚═>OOO╢
║OvO^T^O<═╗O║OOO╔═╗O║OOOOOO^O║
║OOO╠═╝OOO║O╚═>O║TvOvO<>O<68O║
2┐O<╝OOO<68OOOOO║OOOOOOOOO└┘O║
a┘OOOO^OO└5>O<══╝O╔══>O<╗OOOO║
╟OO╔══╩╗OOOOOOOOOOvOOOOO╚>O^O╢
║O<╣OOO╚>O<>O<>O^OOO^O█OOOO╚═╣
║OT║T^OOOOOOOOOO║T^O║OOO┌┐OOT║
╚══╩═╩══╧══════╧╩═╩═╩══╧35═══╝