╔═╦═══67════╤═══╦╤══67╤══════╗
║O║TOO└┘OOOOOOOTvOOO└9OOOOOOT╢
║O╚═╗OOOO╔═>O<╗OOO^OOvOD^O┌┐O║
║OOOvO<>O║OOOO╚╗O<╩╗OOOOvO└┘O║
║O^OOOOOO║O┌┐OO║OOOvO<╗OOOOOO╢
║O╚>O^O<═╣O└5>O╚═╗OOOOvO<>O^T║
║OOOO║OOOvOOOOTOO╚>O^OOOOOO╚═╣
║O<╗OvO█OOO╔═══╗OOOOvO<╗O^OOO╢
║OT║OOOOO<68OOO╚╦═╗OOOO╚═╝O^O║
║O<╝O<═╗OO└┘O^OO║T╚╗O^OOOOO║O║
║OOOOOO╚╗OOOO╠>O║OOvO╠═══╗O║O║
╠═>O<>OO╠>O<═╝OO2┐OOO║OOOvO║T║
╟OOOOOO<╝OOOOOO<35═>O║O^OOO╚═╣
║T^DO^OOOO┌┬┬┐OOOOOOO║T2┬┐OOO║
╚═╩═╧╩════3┴┴5╧══════╩╧3┴5═══╝