╔══════════╦╤╦╤═╦═════╦╤╦════╗
║SOOOOOOOOT║O║OOvOOOOOvO║TOOO╢
║O╔═╗O╔═>O<╣O╚>OOO╔═╗OOO╠═>O<╣
║O║TvOvOOOO║OOOO╔═╣TvO<═╣OOOO║
║O║OOOOO^O╔╝O<>OvOvOOOOO2┐O^O║
║O╚══>O╔╝OvOOOOOOOOO╔═╗O└┘OvO║
║OOOOOOvOOOO<══╦═╗O<╝O║OOOOOO║
║O^D┌┐OOO<╗OOTOvO║OOOOvO╔═╦>O║
║O╚═1┘O^OO╚══╗OOOvO<>OOO║T║TO╢
╟OOO║OO2┐OOOO╚═>OOOOOO^OvO╚══╣
╠═╗OvO<34══╗OOOOO^O<══╝OOOOOO║
║TvOOOOO║OO║O^O^OvOOOOOO<╗O^O║
║OOO<═>OvO<╝O╚═╝OOO╔>O^OD╚═╝O║
║O^OOOOOTOOOOOOOO^O║TO║OOOOOO╢
╚╧╩═════════╧════╩╧╩══╩══════╝