XXXXXXXXXXXXMXMXXXXXXXXMXXXXXX
XSOOOOOOOOTXOXOOXOOOOOXOXTOOOM
XOXXXOXXXOXXOXXOOOXXXOOOXXXOXX
XOXTXOXOOOOXOOOOXXXTXOXXXOOOOX
XOXOOOOOXOXXOXXOXOXOOOOOXXOXOX
XOXXXXOXXOXOOOOOOOOOXXXOXXOXOX
XOOOOOOXOOOOXXXXXXOXXOXOOOOOOX
XOXDDXOOOXXOOTOXOXOOOOXOXXXXOX
XOXXXXOXOOXXXXOOOXOXXOOOXTXTOM
MOOOXOOXXOOOOXXXOOOOOOXOXOXXXX
XXXOXOXXXXXXOOOOOXOXXXXOOOOOOX
XTXOOOOOXOOXOXOXOXOOOOOOXXOXOX
XOOOXXXOXOXXOXXXOOOXXOXOXXXXOX
XOXOOOOOTOOOOOOOOXOXTOXOOOOOOM
XMXXXXXXXXXXMXXXXXMXXXXXXXXXXX