XXXXXXXXXMXXXXXXXXXMXXXXXXMXXX
XOOOOXTOXOOXOOOOXOOOOOXXOOOXTX
XOXXOXXOXXOXXTXOOOXOXOOOOXOOOM
XOXOOOXOOOOOXXXOXXXOXXXXOXOXOX
XOXXXOOOXXXOOOOOOOXOOOXXOXOXOX
XOOOXXOXXTXOXXXXXOXXXOOXOOOXOX
XOXOOOOOOOOOXDXOOOOOXXOXXXOOOM
XOXOXTXOXXXOXOOOXXXOXOOOOOOXOX
XOOOXXXOOOXOXXXOXTXOXOXXOXXXOX
XXOXXOOOXXXOOOOOXOOOOOOOOOXXOX
XXOOOOXOOXXXOXXXXOXXXXOXXOOOOX
MOOXXXXXOOOOOOOOOOXOOOOOXXOXOM
XOXXOOOXXOXXOXXOXOOOXOXOOOOXXX
XOTXTXOOOOOOOOOOXTXOXOOOXXOOTX
XXXXXXXXXMXXXXXMXXXXXXXMXXXXXX