XXXXXXXXXXXXXXXXXXXXXXXXXXXXXX
XOOOOOOOOOOXOXOOXOOOOOXOXOOOOX
XOXXXOXXXOXXOXXOOOXXXOOOXXXOXX
XOXOXOXOOOOXOOOOXXXOXOXXXOOOOX
XOXOOOOOXOXXOXXOXOXOOOOOXXOXOX
XOXXXXOXXOXOOOOOOOOOXXXOXXOXOX
XOOOOOOXOOOOXXXXXXOXXOXOOOOOOX
XOXXXXOOOXXOOOOXOXOOOOXOXXXXOX
XOXXXXOXOOXXXXOOOXOXXOOOXOXOOX
XOOOXOOXXOOOOXXXOOOOOOXOXOXXXX
XXXOXOXXXXXXOOOOOXOXXXXOOOOOOX
XOXOOOOOXOOXOXOXOXOOOOOOXXOXOX
XOOOXXXOXOXXOXXXOOOXXOXOXXXXOX
XOXOOOOOOOOOOOOOOXOXOOXOOOOOOX
XXXXXXXXXXXXXXXXXXXXXXXXXXXXXX