XXXXXXXXXXXXMXMXXXXXXXXMXXXXXX
XSOOOOOOOOTXOXOOXOOOOOXOXTOOOM
XOXXXOXXDOXXOXXOOOXXXOOOXXXOXX
XOXTXOXOOOOXOOOOXXXTXOXXXOOOOX
XOXOOOOOXOXXOXXOXOXOOOOOXXOXOX
XOXXXXOXXOXOOOOOOOOOXXXOXXOXOX
XOOOOOOXOOOOXXXXXXOXXOXOOOOOOX
XOXXXXOOOXXOOTOXOXOOOOXOXXXXOX
XOXXXXOXOOXXXXOOOXOXXOOOXTXTOM
MOOOXOOXXOOOOXXXOOOOOOXOXOXXXX
XXXOXOXXXXXXOOOOOXOXXXXOOOOOOX
XTXOOOOOXOOXOXOXOXOOOOOOXXOXOX
XOOOXXXOXOXXOXXXOOOXXOXOXXXXOX
XODOOOOOTOOOOOOOOXOXTOXOOOOOOM
XMXXXXXXXXXXMXXXXXMXXXXXXXXXXX