XXXXXXXXXXXXXXXXXXXXXXXXXXXXXX
XSOOOOOOOOOXMXMOXOOOOOXMXOOOMX
XOXXXOXXXOXXOXXOOOXXXOOOXXXOXX
XOXOXOXOOOOXOOOOXXXOXOXXXOOOOX
XOXOOOOOXOXXOXXOXOXOOOOOXXOXOX
XOXXXXOXXOXOOOOOOOOOXXXOXXOXOX
XOOOOOOXOOOOXXXXXXOXXOXOOOOOOX
XOXXXXOOOXXOOOOXMXOOOOXOXXXXOX
XOXXXXOXOOXXXXOOOXOXXOOOXMXMOX
XOOOXOOXXOOOOXXXOOOOOOXOXOXXXX
XXXOXOXXXXXXOOOOOXOXXXXOOOOOOX
XOXOOOOOXOMXOXOXOXOOOOOOXXOXOX
XOOOXXXOXOXXOXXXOOOXXOXOXXXXOX
XMXOOOOOOOOOOOOOOXOXOOXOOOOOMX
XXXXXXXXXXXXXXXXXXXXXXXXXXXXXX