XXXXXXXXXXXXMXMXXXXXXXXMXXXXXX
XSOOOOOOOOOXOXOOXOOOOOXOXOOOOM
XOXXXOXXXOXXOXXOOOXXXOOOXXXOXX
XOXOXOXOOOOXOOOOXXXOXOXXXOOOOX
XOXOOOOOXOXXOXXOXOXOOOOOXXOXOX
XOXXXXOXXOXOOOOOOOOOXXXOXXOXOX
XOOOOOOXOOOOXXXXXXOXXOXOOOOOOX
XOXXXXOOOXXOOOOXOXOOOOXOXXXXOX
XOXXXXOXOOXXXXOOOXOXXOOOXOXOOM
MOOOXOOXXOOOOXXXOOOOOOXOXOXXXX
XXXOXOXXXXXXOOOOOXOXXXXOOOOOOX
XOXOOOOOXOOXOXOXOXOOOOOOXXOXOX
XOOOXXXOXOXXOXXXOOOXXOXOXXXXOX
XOXOOOOOOOOOOOOOOXOXOOXOOOOOOM
XMXXXXXXXXXXMXXXXXMXXXXXXXXXXX